0000100000000000
0001000000000010
0010100000000000
0000100000000000
0001000000000000
0010100000000000
0000100000000000
0001000000001010
0010100000000000
0011100000000001
0011100000000001
0101100000000000
0000100000000000
0001000000000000
0010100000000000
0000100000000000
0001000000100010
0010100000000000
0100100000000011
0011100000000010
0011100000000011
0010000000000000
0111000000000011
0011100000000001
0000100000000000
0001000000000001
0010100000000000
0010000000000000
0111000000000010
0000100000000000
0001000000000111
0010100000000000
0100000000000000
